20
1,3,2,2,1,1,1,9,1,1
1,1,1,1,1,1,1,9,1,2
3,1,1,1,1,2,2,1,2,3
8,1,1,1,1,1,1,1,1,1
2,1,1,1,1,1,1,1,1,9
1,1,1,1,1,9,1,1,1,1
1,1,1,1,9,9,1,1,1,1
1,1,1,1,1,1,1,1,1,2
3,1,1,1,1,1,1,1,1,0
1,2,9,2,2,2,9,2,3,3
