20
1,1,1,1,1,1,1,1,1,1
1,1,1,1,1,9,9,9,9,9
1,1,1,1,1,9,0,8,1,1
1,1,1,1,1,9,9,9,9,5
1,1,1,1,1,1,1,1,1,1
1,1,1,1,1,1,1,1,1,1
1,1,1,1,1,1,1,1,1,1
1,1,1,1,1,1,1,1,1,1
1,1,1,1,1,1,1,1,1,1
1,1,1,1,1,1,1,1,1,1

