14
1,1,1,1,1,1,1,1,1,1
9,9,9,1,3,9,9,9,1,1
9,9,9,1,1,1,1,9,1,1
0,9,9,1,1,9,1,9,1,1
1,9,5,1,1,9,1,9,1,1
1,1,1,1,1,9,1,9,1,1
1,1,1,1,1,9,1,9,1,1
1,1,1,1,1,1,1,9,1,1
1,1,1,1,1,9,9,9,1,1
1,1,1,1,1,1,1,1,1,1
