19
1,1,1,1,1,1,1,1,1,1
9,9,9,9,9,9,9,9,1,1
9,1,1,1,1,1,1,9,1,1
9,1,9,9,9,9,1,9,1,1
9,1,9,9,0,9,1,9,1,1
9,1,1,1,1,9,1,9,1,1
9,9,9,9,9,9,1,9,1,1
1,1,1,1,1,1,1,9,1,1
1,1,1,1,1,9,9,9,1,1
1,1,1,1,1,1,1,1,1,1
