50
1,1,1,1,1,999,1,1,1,1
9,1,1,1,1,999,1,1,1,1
9,9,9,1,1,999,1,1,1,1
9,9,9,1,1,999,1,1,1,1
1,1,1,1,1,999,1,1,1,1
1,999,999,999,999,999,1,1,999,1
1,1,9,1,1,9,1,1,999,1
1,1,2,8,9,2,1,1,999,1
999,999,999,999,999,999,999,999,999,1
0,1,1,1,1,1,1,1,1,1